NO ./Textures/texture_north.ppm
SO ./Textures/texture_south.ppm
WE ./Textures/texture_west.ppm
EA ./Textures/texture_east.ppm

F 60,50,60
C 8,34,42


111111111111111111111111111111111111
100000000E00000000000000000000000001
111011111111111111111111111111111111
  101
  101
  101
  101
  101
  101
  101
  101
  101
  101
  101
  101
  101
  111
