NO ./Textures/texture_north.ppm
SO ./Textures/texture_south.ppm
WE ./Textures/texture_west.ppm
EA ./Textures/texture_east.ppm

F 60,50,60
C 8,34,42







1111
1001
1001
1001
1001
1001
1E01
1001
1001
1001
1111




