NO ./Textures/texture_north.ppm
SO ./Textures/texture_south.ppm
WE ./Textures/texture_west.ppm
EA ./Textures/texture_east.ppm

F 60,50,60
C 8,34,42

1111111111111111111111111111
1000000011000001110111111111111
110111111111011100000010001
110111111111011101010010001
100000110101011100000010001
100000000000001100000010001
100000000000001101010010001
100001110101011111011110N0111
110111 1110101 101111010001
111111 1111111 111111111111
