NO ./Textures/texture_north.ppm
SO ./Textures/texture_south.ppm
WE ./Textures/texture_west.ppm
EA ./Textures/texture_east.ppm

F 60,50,60
C 8,34,42







11111111111111111111
10000000000000000001
10000000000000000001
10001100000000000001
10000000000000000001
10000000000000000001
1000000N000000000001
10000000000000011111
10000000000000000001
10000000000000000001
11111111111111111111




